...................................................................................................................................
.................##.........#....#................##...................###....#..........#...#..#.#..#....#.......##.............#.
.#........#..........#....#........#.......................................#.....#............#..#..#.......#..#....#.........#....
.#.................##.#............#.....#...............................#........#...........#.........................#..........
........#...#..............#....#.#...#...................................#............##..#...#....#...................#..........
..#..##............#.#..#..##......##........#.......#..#.......#..............#.#..#...##.........................#...............
...#.......#.........#.#.......#..#.......#..........#..........#................#......#.....................#.......#...##...#.#.
.#....#.........#...................#.......#......#..#.........#..#.........#..........#..#..##...#.........##.........#..........
.....#.........#..#......#.........#.........#......#.............................#.........#....................##...#..#.........
..##..............#..............#........#.........#..............................#...#...#.....#............#..###...#..#....#...
...........#......................#....###..##.............#.##.....##.........#.#........#..#.....#...............................
.........#..#.....#....#.#.#....................#.#..................#...........................#....#...#...............##..#.#..
.#....##...##..#...............##.#...#.......##.............#..#.#......#.......#..#.......#.#.......#......#.....#....#...#......
.............#.........#............#...................#................#..............##.....#...#........#....##.......#..#.....
.##..#.....#....#........##.....#.#............#..........#...............................##......#............#..#.............##.
.#.....#........##.............#....##...##.......................#..#...................##...#......#.......#.........#.......#...
.....#...................#...#..#......#....#................#....#..#...#........................#...#...........#.#..............
...#.....#....##.....##...#.#........##...#.#...........####...#.......#.......................#.........#....#..........#.#.......
.......#.#....#.....#......#........#..#.................#....#...#.##...................#...##....#.....#..#.#.....#...##.....#...
.......##..##..#.....#.#..#........#...................................#.#...####........##.#.......#.....##....#.....#.#.#........
..#......#......#.......#.......#......#.................#.###.........#..#.................#..###.#....#......#...#...##..........
....#.......#...#....#..............#..................#.#..#..#.....#.......#................#...........#.....#.......#.#.....#..
.....#.#.....#..##..........##.#....##.............##...............#...........##..................#....#.#......#....##..#.....#.
....#.....#...................#...#...........#................#......#..#.#.......##........#......#...#....##........#.......#...
.......#.#.......#.........#...#..#..........##..............#....#..........#.#....#.........#..#...#..............#.........#....
.....#....#.....................................#.........#.......###....#..............................##..........#.#.#..........
..#....###.......#...........#...#.........#......#........#..#.....#..........#...................#..#.......#.......#.#.....##...
...........#....#...#....#........#.......#.##.##.................###.#...##....#.#......................#...###...........#.......
...........####.....##.#....#...................##.....#...#..#.#.#............#..#.....#.........#.#...##...............#.......#.
...#.......#.#..........................#.##...#.#..#....#........#...#..#..#.....#................#..............#..####...#......
................##.......#.....#...........#..#......##......#.#.......#...........................#.........#............#........
......#............#...#.................#.......#...........#.......#.#...#..#........#...............#.....#...#.......#.........
....#....#....#......#..#...............##...#.....#........#..........##.........##.....##...........#.#.#.#.................#....
.##.................#..#............................##..#.............###..#.........#.......................#.....#...............
........#.............#....................##.#.....#.#.....#.#......#.......#.#.#...#.....#...#.............#......#.##.##..#.#.#.
..#..#.........#.....#..#.........#......#.#....#.#...#...#.#..........#.......#...#.......#....................##............#....
......#....#.#.........................#....#.....#..#...#........#..#.#...................#.#.....................#.##............
..............#..#..............#...##.....#.#.#.#..#.....#.........###......#............#....##.............##..#..#..##.......#.
.....#...#.#......#............#..#.#.....................................#..................#..#.................#................
........#..#..#....................#....#.#.............#....#..........#...........#.#...#.#......#..............##.....##.....#..
.....##.........#......................###........#.##...#.#..#.#...#...............#...#..#...#.....................#.............
...........#...................#.#....#.#...........##....#.#..#..............#....#.............#..............#....#..#..........
....#...#..........#...................#..................#.....#....#....#......................#...............#.....#..#...#....
.......#....#.#...........#....#.......#....###................#...............#.......#..#.......##.#..........#....#.............
....##...#....#.#..........###.................#..#.....##.........#...........#...#....#..........#....#...........#..##..........
.........#..............#..##......#.#.........#.......#....#...#.........................#.........#..#...........#..#............
..#........................#.....#.........#....#........##.....#...............#......#...#.##..#........#......................#.
..#....#.................#......#...##.#..............#..##...#.#.....#........##.........###..........#.........................#.
....#..................#....#..#...#....................#.#............##..#.#..#....#..#.#......#..#......#...............##...#..
.........#..........#.......#...##.....#.#..............#....#..#.#....#.....##.....##...........#.#...............................
.........#.#.........#....#.........#.#.............##.#.#.....#...#.......#....#....#.##.....#.......##.#.#...#...........#.#...#.
..........#.............#.......................#.............................##.......#.#...#.......#...................#..#......
.#.......#............#.#..#...........#..............#..##...............#...#..#..........................#...................#..
...#.............#...#........#.#..#.....#.....##..................#............#..............#.....#......#..............##......
.......#..................#......#.#..#............#.......#..#.........#..#...............#..............##.#.#.#.#.............#.
...#.##...........#.....#......#...#..#...#........#.....#....#.....#....#.........#..........#.#.......#.....#...#................
.....#.......#.#...............#..##...#.#.#....#.................#...........#.#..#..#..........#..##.##..#....#...#..............
.#.....................#...........##.....#......#..........##...........#........#..............#.....##....#.......#.........#...
...#........#...........#..........................................#....#............#........#.#.........#.#..........#.........#.
.............##.......#.............................#....#.....#.....#.......##.....#.....#.#.#..................#..............##.
..........#.......#......#..#.##.......#.........#..#......#.#..............#....#........#..#...#..#................#...#.........
........##........#...#.....#...............##..........#..................#.#....##..#....#....#.#........#.##......#..##.........
.......###......#...#...#....................#.......#...............#..#......##..#...........#.............#.....................
.........#................#......#................####..#...#...#.....#...................#.#...#..................................
............#....#...............#.#..#.......#..........#......#.##....#.......#.#..........#........#....##.....#..#.............
.................................................................S.................................................................
................#.#.....#......#.##.#......#...........#....#........#....#.......#....##..................#.....#.......##........
......#..#........##.#.#..#.........#......#....#.#.....##.....#.......#.........#.#...#..................#....##..........#.......
...........#............#.......#.............#.#.#...........#........#..#...........#..#.#......#.#.....#........................
.................#.....#..##..#........................#....................#..#..#...#......#............#........#....#..........
...........#...#..#....................#......#.......#........#..#.#.#......#......#.....................#.......#......#.........
.............#....#...#...................#.#....#....#...#............#....#............##...................#.......#............
................#....#..###.....##....#........#..................#.....##.......#.........#..#.......#......#.......#.#...........
...#.............#..#........#................#...#.#.#.....#.#.#.#..##.......#.#..................#.......#.......................
..#...........##..#....#.....#.#.............#....#..........................................#..#..........#.#..#..................
..#.................#......................#.................#..#.....#............#..#...##.#.........#..#.#.#.................#..
...............#...........#..#....#..#.#......#..........##..#...#.#...##...##.....#...#...#........#.#...........#..........#.#..
......#................#.#.....#.................#..#..#..............#........#..............#.#..#...............................
..................#.....#.#....................................##..............#...#.......#................#...................#..
.#...#..#.............##.###..#..#..#.#.....#.......###...#...........................#...#......#........#..#............#....#...
......#............#...#.#..#.#..##..........#....#..................#.............#.#..##.........................................
...........#...........#.......#......#.......#..........#..##.......#........#.............##....##.....#.........................
......................#.....#.#.#....##..........##........................#....#.........##..##.............#.....................
.........#...#........#...#.....................#.....#........#.............##........#.#.#.......#.......##....................#.
.#.........#........................#..#....#........#..#.#....##........#....#..#....#.##...#........#....#...........#......#....
.#...#..#....#..........#....#..#..##.#....#.................##...#......................#...#..#....................#.#...........
.#...#...###...............#......##....#.#.............##..#.##.........#....###...................#.............#................
....#.....###................#.......#........#.........#.......#..##.......................##.....#................#..#...........
..................##.........#.........#..........#..................#....................#.....#..#..#.............#............#.
..#.....#..........##...........#...#.....###........#.#.#.....##..#....#..#.......#......##..#......................#..#.#....#...
....##.##....................##.....###............#..........#..........##...........#........#.##....................#...........
......#.#..#.....#....................#..#...###.#........#....#.........#.....##.................#.#..........#.#..............#..
.#......#....................................#....#...#......#..#..#.......#.#..#........#..##...................#.................
.#..................................#...........##...............................#.#............#.#..............##.....#......#...
.................#....#..#.........#..##.#...##......#.......#...................#.......................#.#......#.......#....#...
..#..#.##.....#.....................##..#..##..#..#.............................#.#................................................
........#.......##...#...#.#..........##.......##...#....#.....#..............##....#..#.....................#.....#..#..##..#.#...
.............#.#.#.........................................#..#.........#..#..........#.#..##.........#..##...#...#...##...#.......
..#...........#..............#........#.......#.#..#............#...#....#.....#........#..............#........#.....#............
.............#...#......#.....#.......#..#....#.....#....................#..............#..#........................#..............
........#...#....#.#...#.#..................#....##..#..#..#..#....#...........#.#..........................#......#.#.#.........#.
.....#.............#..#......#..#........#........#.##.#...........................................#........#....#.......##.#......
....#.##..........#....###.................#................##...............#...........#...............##................#...#...
.#...#....##..##...................................#..............#.#..#.....#.....#...#...........#..#........#..#.....#..........
..#.##..#......#...#.#....#................#...........#..........#..#.#...#........#............#....#........#.........#.........
...........#.....#..................#...........##............#...............................#.......................#....#.......
.....#...#.....#............#.................#......#...#.#............#......#....................#..#....................#......
...#.#......#.......#........#.....................#.....#........#.#.#..........#..........##..............#.....#..............#.
...#..#........................................#...#.....#........#................#........................#......#..#....#.......
........#............#..#..........................###..#.............#..#.....##..........#..#..##....#........#.......#..........
...#..#.....#....#.........#...#.#........................#........#...#.....##..........#.#.......#............##....##.........#.
.#..#........#.......................#.............##......##..#........#..#...#...................##..........##.#..#.....#.##....
.###....#.....#...................#..#...............................#......#.......................##.#...#......#.....#......#.#.
......#.....................#.#.....#..#............#........#........#.....................#..........##.#........#...............
...#..#........#..............#..........#................#...#......##.#.##..........#....................#....#...#...#..........
.#.............##.#..#.........##..###..##..#.........#..##.................#.........#........#..............#.......####..#..#...
..#.....#..............#............#..#...#.................#......#...............#...#.....#.....#..#.#...##..#.....#.......#...
....##......#..............#....#.#....###....#.............#.#.....####.#..........#.#...............#......####.....#........#...
....#................#.............#...#..#..##...........#...........#.#..........#.........#..#....#..#......................#...
....#..#.......#..#.#..#...............#..#......#........#.............#...........#....##........#.#...#.#....#........#.##.##...
.#..........#..............#.#............#.......#....................#........#.............#.....##..#..#..#..##................
............#............#...#.......#.........................................#.............#..........#...................#..#...
..#.#..#............#.#..#......#....#........#..#.................#.........#.#.#..##......#.#...................#................
.................#..#..#.......#......#..#.......#....#.......#.................#.#...#...........#..................#..#........#.
....#.......#......#......#.........##.#....#..##...#.........................#...#...##..###.......#....##........##.#....#.#.....
.......#.....#......#.....................#..........#..#.......#....................#..............#....#...#.#..#........#.#..#..
.............##..#............................#..#..........................#..#.#.....#.##.........#..#........#....#......##.....
..........##............#.#...........#.#..............#..#................#..#.#...#..#............#..#......#.....#.....#....#.#.
.##.#..#......##......#........#..#.#......#..............................####..##.##.............#......#..............#..........
.......#.....#......#..#............#...........#.....###.................#...#.#....#...........##.......#.#...##.........#....#..
...................................................................................................................................