$$..../........-...-........-.-.|..................-...........................-.........-...---..............
..../.....................$...........|........|...........$...|./...-...|..|.|-.....-.....|........$....../..
............|...........$.....................$....|.....|/./........../.....................-................
.......$.|.$-....--../..........$.../.../.../......................$.............$............................
.............$/...../..........................|....-.....-.......$|...........-....|.........................
.-............-../......|.............-................../|....-...-....../|...-....--...$.......$..|.......-.
.......-......./....................$......................$.....|........../.......$............|..$../.../..
........................-.....$.......$........................./............................|......$..-......
...................-................./......|.....-....$$............./.....$.................................
.............|.........................$.|.....|$....../.......|..............$$../..................../......
-......$......./........$.-/...................|../-./................/.........................|......$.....|
..........................$...........................$...........................|...........................
....-...../|.............................-........./...-..................|..........$..$................$....
............/........-.-.................//..$................................-.......|.-............//....-..
.......-.....|.$........$...|....-......./......$.......-.......$...................../...$...................
...$.|..-........./........................-.....|..-............................$..-.........................
..../.........................................--.............|...................................$..../....../
..........$...........--........./.|.......$./................/.........$.|..|......$........-//............./
...$.|..$......$.......-$........$|......./.......$..|...........-..............$-..|...................$.....
..../........|..|.........................../..$....................|.......$.......................-........$
.....$.......$...$.|.........$.................|......|..-...................-.../.$...................|......
........$................./..............-....-..................|.....$|$................./...../............
.|................$../..........................|.....$.......................................................
...|.........................|........|...|...$.-.-...................$..|./..$$......|.../..................-
......-..................................|.................................$.|.$..-........$..................
.-..........$|..-.....-.$..-...............$........-.....................-.....|....................$..|.....
..../....-..............................-$................................................................../.
............./....................$...................|...........$.../.............-......-....-.............
........../....../..-.|.............$$......../.....................|....-..........$.........$....../........
.............|......$......../../..........|...........-......$|........$...........././....$..........|......
......-................../.....-................-..............$.-..............|................|............
...-...-./..................................................|.$..$........$-........-.................$.......
.......................$.$.........|................$....../.|....$.../..$.|$.....-.|..............-..........
..-.........-|...$.$....|.-.$........................$........................./.-................/..........-
.........|.......-.................$/......../...............$..|..................|....|..$..|.............$.
......$........................-......$..-...-..........-......./....$........................$..............-
.......$...-....$$...........................$......................./..|../........./................|....../
...............|...|..$..-......................../............$-............/.$..........-........|.........$
...-..$......|......$............/................/...$../.|../...........|-...........$.........$.....-..|...
.........$.....-......|..................-.....................................................-.............|
....../.....|.................|./....-$......................|...-..............|...$..-.......|.......-../...
................................/............$..........$................./............$.-.....|............/.
........$.............$.......|..................-.......................-....................................
....-.-................$..............-......-.../............$............................../|...............
............................$.$..........././........|..$/....-|...................$.......-...../.$..........
-.................../...$....../.|.........................../..........$...........$..........|......-.......
...|-|...............|...$..../|.............-...............$.........-....|-...................|............
..$$.......$.....|....$./$............./.|...../...$...........................-.......--......-.......$$.....
....-..//...../....................|....-...../$..................................|......................-....
......................................../..-...................../.......|.--......$....|..-..$...............
.......-..$........../..................-........$...........|..|.....$...-.....$../.-..$.....-.||...|..-.....
/./....../|...................-............/.....|..-..................................|........./$....-......
................/............................/......-...$...............................$..........-....-....|
.........$.....$......-.....$.........................-............./........./......$...................$....
.....................|...................|...........-............./........$.........../.................$...
........................................../................-|.......||....$...|......$........................
|..-.../|......-............-.....||...|...........-./....................../...$....$-........//......$......
../.-......../........./.-..|..|....||........./......-..$................../.....|.....|...|....|$...........
.-/..$...........$........$...............$..................|......../............-...........-..........|...
...|..|................|............./$....-....-...-......-......-................-................/........|
..-....$....|...../..........|..-./.$......./|.........$.....-|.......$.......................-...|...........
-.......$$...................-....$|........|............|.......................$.............$....../....$./
-......................................../.............-./$.........$.|......./|......../.....|...............
........-.$$$...............-.../............$.................||.............../../..........................
.....................$............$............................-..|.........$......................../........
$..././.....|....|.....-............$./....-.............|..-...-..........-.|....-...$..........|....$.......
.|..........|.....|.......$................................../......./.../...|....$...-..-...$................
..$...$......-..........................................-.........../........--..........--......|............
................................||...-.....|.....-.$..............$.|...$...............-...-.................
............................../..$..|....../.......$......$...-..|../............-.......................$..$.
./............./..|.......|............-.........|.......$../...................|....$...................../..
.|...................|$...................|.....................-.......$...|................-|...............
/|......./../.........$.................$............../.../......|....|......./....|-..........$.............
............|....$.............-.....-./|/.................../......./.$...-.........-..................|.....
.-.../..........................$$.......|.......|.....-........../........$.................|.|..............
....-.$....................../.-......||................/$$.........../..............|........................
$/.....$....-......|...................|.$......$.|............/...$.|.../................|.$.................
..-.$...............-......../.......$....../........-.......-$....../......|../..................|../........
..-./..........$.....................................|.........-.......|................/........|............
.............-....../......./......................|.............../............$..../........................
..|......-........|...................-...........|............../........................|../................
..../..........|-.....-......./....../......./.$.....$.........-...|......................................$...
....$......../..................../..-......|..............-.................||...........$.$...|/............
........$.............|.................................$......./.............-.......|..............$.-......
.....|...........-.............|..........-......$..................................|..-............$.../.$.-.
..................................$...........$...$.......$................$-.................../.............
......-............../...........-......$./..........|..$..................|...|....|...|-./..............|...
........$..|.$......................../..........$..........$.|..|../....$..|.....|.|..............$..-.......
...........-..........|..../.-........../..................|......./.................$.............../........
..........-..../$....$........./............/..................$..........-/................................//
.............-../.-.............$.............../-....-....|..../.............|...............................
........./............|....................|./........$...../................................-.......|........
........./..../..........$..$.....././.........|...........$..................../....../...$.........../.../..
.-....$.........$....-............/...................-.....|.....................|...........................
................-.......................|.........|.................................................$.......|.
...../............|....//...../................|.$...........|............$.....|-........|.........$.........
$..././-....................|...................-..............-..............|.........|....|............./..
..-...........................././-./...$-.................|...-.....-/........$....|............$-..-........
...............|...............//........../.......-.-......................-.........|.............$.........
../............/..................$$......../............................$................../........./.......
......|.$...............................................|................................/.........-.-........
....$.$...$..................-..-.................$$.....-....|................$.................|............
........................./.............-...|./.................$....|....$..|...|..........$-.................
..........|.............$..................$..................../.$.......|..................$/......|........
............|....$..$..../...........-....$....................$...........................-../...............
.....................|......../.././.............$......|.-......$.............-../...|...............-......|
..................-...................................................-.............$............./.|......-..
...$.............||...........................$........$......-......-..$...$...$............./-...........|..
...$........|...................|.......|.............|..-......../..-...-............/.........$....|........
......-...........|................./......|.....-./|..$$...............$|././...............-........$....$..